-------------------------------------------------------------------------GGGGGGGG

-------------------------------------------------------------------------GGGGGGGG

-------------------------------------------------------------------------GGGGGGGG

-------------------------------------------------------------------------GGGGGGGG

---------------------------------------------------------------------------------

---------------------------------------------------------------------------------

---------------------------------------------------------------------------------

---------------------------------------------------------------------------------

---------------------------------------------------------------------------------

---------------------------------------------------------------------------------

---------------------------------------------------------------------------------

---------------------------------------------------------------------------------

---------------------------------------------------------------------------------

---------------------------------------------------------------------------------

---------------------------------------------------------------------------------

--------------------------------------------------------------------GGGGG--------

--------------------------------------------------------------------GGGGG--------

---------------------------------------------------GGG---------------------------

---------------------------------------------------------------------------------

---------------------------------------------------------------------------------

---------------------------------------------------------------------------------

--------------------------------------------------------------------------GGGGGG-

--------------------------------------------------------------------------GGGGGG-

---------------------------------------------------------------------------------

---------------------------------------------------------------------------------

----------------------------------GGG--------------------------------------------

---------------------------------------------------------------------------------

---------------------------------------------------------------------------------

---------------------------------------------------------------------------------

--------------------------------------------------------------------GGGG---------

--------------------------------------------------------------------GGGG---------

---------------------------------------------------------------------------------

------------------------GGG------------------------------------------------------

---------------------------------------------------------------------------------

---------------------------------------------------------------------------------

-------------------GGG----------------------------------------------------GGGGGGG

--------------------------------------------------------------------------GGGGGGG

--------------------------------------------------------------------------GGGGGGG

--------------GGG------------------------------------------------------GGGGGGGGGG

-----------------------------------------------------------------------GGGGGGGGGG

-----------------------------------------------------------------------GGGGGGGGGG

--------------------------------------------------------------------GGGGGGGGGGGGG

-GGGGGGGGGGG-------GGGG-----GGGG------GG-------GGG------GG----GG----GGGGGGGGGGGGG

-GGGGGGGGGGGGGGGGGGGGGGGGGGGGGGGGGGGGGGGGGGGGGGGGGGGGGGGGGGGGGGGGGGGGGGGGGGGGGGGG

-GGGGGGGGGGGGGGGGGGGGGGGGGGGGGGGGGGGGGGGGGGGGGGGGGGGGGGGGGGGGGGGGGGGGGGGGGGGGGGGG

-GGGGGGGGGGGGGGGGGGGGGGGGGGGGGGGGGGGGGGGGGGGGGGGGGGGGGGGGGGGGGGGGGGGGGGGGGGGGGGGG

