---------------------------------------------------------------------------------

---------------------------------------------------------------------------------

---------------------------------------------------------------------------------

---------------------------------------------------------------------------------

---------------------------------------------------------------------------------

---------------------------------------------------------------------------------

---------------------------------------------------------------------------------

---------------------------------------------------------------------------------

---------------------------------------------------------------------------------

---------------------------------------------------------------------------------

---------------------------------------------------------------------------------

---------------------------------------------------------------------------------

---------------------------------------------------------------------------------

---------------------------------------------------------------------------------

---------------------------------------------------------------------------------

---------------------------------------------------------------------------------

-GGGGGGGGGGGG--------------------------------------------------------GGGGGGGGGGGG

-GGGGGGGGGGGG--------------------------------------------------------GGGGGGGGGGGG

-GGGGGGGGGGGG--------------------------------------------------------GGGGGGGGGGGG

-GGGGGGGGGGGG--------------------------------------------------------GGGGGGGGGGGG

-GGGGGGGGGGGG--------------------------------------------------------GGGGGGGGGGGG

-GGGGGGGGGGGG--------------------------------------------------------GGGGGGGGGGGG

-GGGGGGGGGGGG--------------------------------------------------------GGGGGGGGGGGG

-GGGGGGGGGGGG--------------------------------------------------------GGGGGGGGGGGG

-GGGGGGGGGGGGGGGGGGGGGGGGGGGGGGGGGGGGGGGGGGGGGGGGGGGGGGGGGGGGGGGGGGGGGGGGGGGGGGGG

-GGGGGGGGGGGGGGGGGGGGGGGGGGGGGGGGGGGGGGGGGGGGGGGGGGGGGGGGGGGGGGGGGGGGGGGGGGGGGGGG

-GGGGGGGGGGGGGGGGGGGGGGGGGGGGGGGGGGGGGGGGGGGGGGGGGGGGGGGGGGGGGGGGGGGGGGGGGGGGGGGG

