--------------------------------------------------------------------------------------

-GGGGGGGGGGGGGGGGGGGGGGGGGGGGG--------------------------------------------------------

-GGGGGGGGGGGGGGGGGGGGGGGGGGGGG--------------------------------------------------------

--------------------------------------------------------------------------------------

--------------------------------------------------------------------------------------

-------------------------------GGGGGGG------------------------------------------------

-------------------------------GGGGGGG------------------------------------------------

--------------------------------------------------------------------------------------

--------------------------------------------------------------------------------------

----------------------------------------GGGGGG----------------------------------------

----------------------------------------GGGGGG----------------------------------------

--------------------------------------------------------------------------------------

--------------------------------------------------------------------------------------

------------------------------------------------GGGGGGGG------------------------------

------------------------------------------------GGGGGGGG------------------------------

------------------------------------------------GGGGGGGG------------------------------

--------------------------------------------------------------------------------------

--------------------------------------------------------------------------------------

-----------------------------------------GGGGGG---------------------------------------

-----------------------------------------GGGGGG---------------------------------------

-----------------------------------------GGGGGG---------------------------------------

-----------------------------------------GGGGGG---------------------------------------

------------------------------GG---GG-------------------------------------------------

------------------------------GGGGGGG-------------------------------------------------

-------------------------GG--GGGGGGGG-------------------------------------------------

-------------------------GGGGGGGGG----------------------------------------------------

-------------------------GGGGGGGGG----------------------------------------------------

--------------------------------------GGGGGGGGGG--------------------------------------

--------------------------------------GGGGGGGGGG--------------------------------------

----------------GGG-------------------------------------------------------------------

----------------GGG-------------------------------------------------------------------

----------------GGG------------------------------GGGGGGG------------------------------

----------------GGGGG----------------------------GGGGGGG------------------------------

----------------GGGGG----------------------------GGGGGGG------------------------------

----------------GGGGG-----------------------GGGGGGGGGGGG------------------------------

----------------GGGGGGG---------------------GGGGGGGGGGGG------------------------------

----------------GGGGGGG----------------GGGGGGGGGGGGGGGGG------------------------------

---------------------------------------GGGGGGGGGGGGGGGGG------------------------------

---------------------------------------GGGGGGGGGGGGGGGGG------------------------------

---------------------------------------GGGGGGGGGGGGGGGGG------------------------------

---------------------------------------GGGGGGGGGGGGGGGGG------------------------------

------------------------------GGGGGG---GGGGGGGGGGGGGGGGG------------------------------

------------------GGGGGGGGG---GGGGGG---GGGGGGGGGGGGGGGGG------------------------------

------------------GGGGGGGGG---GGGGGG---GGGGGGGGGGGGGGGGG------------------------------

------------------GGGGGGGGG---GGGGGG---GGGGGGGGGGGGGGGGG------------------------------

------------------GGGGGGGGG---GGGGGG---GGGGGGGGGGGGGGGGG------------------------------

------------------GGGGGGGGG---GGGGGG---GGGGGGGGGGGGGGGGG------------------------------

------------------GGGGGGGGG---GGGGGG---GGGGGGGGGGGGGGGGG------------------------------

------------------GGGGGGGGG---GGGGGG---GGGGGGGGGGGGGGGGG------------------------------

------------------GGGGGGGGG---GGGGGG---GGGGGGGGGGGGGGGGG------------------------------

------------------GGGGGGGGG---GGGGGG---GGGGGGGGGGGGGGGGG------------------------------

------------------GGGGGGGGG---GGGGGG---GGGGGGGGGGGGGGGGG------------------------------

------------------GGGGGGGGG---GGGGGG---GGGGGGGGGGGGGGGGG------------------------------

