-------------------------------------------------------------------

-------------------------------------------------------------------

-------------------------------------------------------------------

-------------------------------------------------------------------

-------------------------------------------------------------------

-------------------------------------------------------------------

-------------------------------------------------------------------

-------------------------------------------------------------------

-------------------------------------------------------------------

-------------------------------------------------------------------

-------------------------------------------------------------------

-------------------------------------------------------------------

--------------------------------------------------GG---------------

-------------------------------------------------GGGG--------------

----------GGG--------------GGG-------GG---------GGGGGG-------------

----------GGG--------------GGG-------GG--------GGGGGGGG------------

----------GGGGG----------GGGGG-------GG-------GGGGGGGGGG-----------

----------GGGGG----------GGGGG-------GG------GGGGGGGGGGGG----------

----------GGGGGGGG-----GGGGGGG-------GG-----GGGGGGGGGGGGGG---------

GGGGGGGGGGGGGGGGGGGGGGGGGGGGGGGGGGGGGGGGGGGGGGGGGGGGGGGGGGGGGGGGGGG

GGGGGGGGGGGGGGGGGGGGGGGGGGGGGGGGGGGGGGGGGGGGGGGGGGGGGGGGGGGGGGGGGGG

GGGGGGGGGGGGGGGGGGGGGGGGGGGGGGGGGGGGGGGGGGGGGGGGGGGGGGGGGGGGGGGGGGG

GGGGGGGGGGGGGGGGGGGGGGGGGGGGGGGGGGGGGGGGGGGGGGGGGGGGGGGGGGGGGGGGGGG

GGGGGGGGGGGGGGGGGGGGGGGGGGGGGGGGGGGGGGGGGGGGGGGGGGGGGGGGGGGGGGGGGGG

