---------------------------------------------------------------------------------

---------------------------------------------------------------------------------

---------------------------------------------------------------------------------

---------------------------------------------------------------------------------

-----------------------------------------------------------------GGGGG-----------

----------------------------GGGG---------------------------------GGGGG--GGGG-----

---------------------------------------------------------------------------------

---------------------------------------------GGGGGGGGGGGGG-----------------------

---------------------------------------------GGGGGGGGGGGGG-----------------------

----------------------GGGGG------------------------------------------------------

-----------------------------------------------------------------------------GGGG

---------GGGGGGGGGGG-------------------------------------------------------------

---------GGGGGGGGGGG-------------GGGGGG------------------------------------------

---------------------------------GGGGGG------------------------------------------

---------------------------------GGGGGG------------------------------GGGG--------

-GGGG----------------------------GGGGGG------------------------------------------

-GGGG----------------------------GGGGGG-------------------GGGGGGG----------------

-GGGGGGGG------------------------GGGGGGGGGGGGGG----------------------------------

-GGGGGGGG------------------------GGGGGGGGGGGGGG----------------------------------

-GGGGGGGGGGGG--------------------GGGGGGGGGGGGGG----------------------------------

-GGGGGGGGGGGG--------------------GGGGGGGGGGGGGG----------------------------------

-GGGGGGGGGGGG--------------------GGGGGGGGGGGGGG----------------------------------

-GGGGGGGGGGGGGGGGGGGGGGGGGGGGGGGGGGGGGGGGGGGGGGGGGGGGGGGGGGGGGGGGGGGGGGGGGGGGGGGG

-GGGGGGGGGGGGGGGGGGGGGGGGGGGGGGGGGGGGGGGGGGGGGGGGGGGGGGGGGGGGGGGGGGGGGGGGGGGGGGGG

-GGGGGGGGGGGGGGGGGGGGGGGGGGGGGGGGGGGGGGGGGGGGGGGGGGGGGGGGGGGGGGGGGGGGGGGGGGGGGGGG

-GGGGGGGGGGGGGGGGGGGGGGGGGGGGGGGGGGGGGGGGGGGGGGGGGGGGGGGGGGGGGGGGGGGGGGGGGGGGGGGG

-GGGGGGGGGGGGGGGGGGGGGGGGGGGGGGGGGGGGGGGGGGGGGGGGGGGGGGGGGGGGGGGGGGGGGGGGGGGGGGGG

